1111111111111111111111111111111111
10001001E0000001C00000C00000000001
1010010110100000101001000000010101
1110010010101010001001000000010101
1P1000000C00C0000000000000000001C1
1111111111111111111111111111111111