1111111111
10000E0001
100P00C011
1001100C01
1111111111