111111111111111111111111111111
10E000000000000C00000C00000001
10100101001000001010010000C001
101001001010101000100100000001
101000000C00C00000000000C00001
100000000000000P00000000000001
1000000000C000000000000000C001
111111111111111111111111111111