111111111111111
10000000000E001
1000000000C0001
100000000000001
1C00000000P0001
111111111111111