111111111111111
10000000000E001
1000000000C0001
110000000000001
1C11000000P0001
111111111111111